+-----------+------------------------------------+
|           |                                    |
| (closet)  |                                    |
|         P |                            S       |
|         P |         (sleeping room)            |
|         P |                                    |
|           |                                    |
+-----------+    W                               |
|           |                                    |
|        W  |                                    |
|           |                                    |
|           +--------------+---------------------+
|                          |                     |
|                          |                W W  |
|                          |    (office)         |
|                          |                     |
+--------------+           |                     |
|              |           |                     |
| (toilet)     |           |             P       |
|   C          |           |                     |
|              |           |                     |
+--------------+           +---------------------+
|              |           |                     |
|              |           |                     |
|              |           |                     |
| (bathroom)   |           |      (kitchen)      |
|              |           |                     |
|              |           |      W   W          |
|              |           |      W   W          |
|       P      +           |                     |
|             /            +---------------------+
|            /                                   |
|           /                                    |
|          /                          W    W   W |
+---------+                                      |
|                                                |
| S                                   W    W   W |
|                (living room)                   |
| S                                              |
|                                                |
|                                                |
|                                                |
|                                                |
+--------------------------+---------------------+
                           |                     |
                           |                  P  |
                           |  (balcony)          |
                           |                 P   |
                           |                     |
                           +---------------------+


